#####
#   #
#   #
#   #
#   #
#   #
#   #
#   #
#   #
#   #
#   #
#   #
#   #
#   #
#   #
#   #
#   #
#   #
#   #
#   #
#   #
#   #
#   #
#   #
#   #
#   #
#   #
#   #
#   #
#   #
#   #
#   #
#   #
#   #
#   #
#   #
#   #
#   #
#   #
#   #
#   #
#   #
#   #
#   #
#   #   
#   #
#   #
#   #
#   #
#   #
#   #
#   #
#   #
#   #
#   #
#   #
#   #
#   #
#   #
#   #
#   #
#   #
#   #
#   #
#   #
#   #
#   #
#   #
#   #
#   #
#   #
#   #
#   #
#   #
#   #
#   #
#   #
#   #
#   #
#   #
#   #
#   #
#   #
#   #
#   #
#   #
#   #
#   #
#   #
#   #
#   #
#   #
#   #
#   #
#   #
#   #
#   #
#   #
#   #
#   #
#   #
#####