#####
#S  #
# ###
#   #
#  E#
#   #
#   #
#   #
#   #
#   #
#   #
#   #
#   #
#   #
#   #
#   #
#   #
#   #
#   #
#   #
#   #
#   #
#   #
#   #
#   #
#   #
#   #
#   #
#   #
#   #
#   #
#   #
#   #
#   #
#   #
#   #
#   #
#   #
#   #
#   #
#   #
#   #
#   #
#   #
#   #   
#   #
#   #
#   #
#   #
#   #
#   #
#   #
#   #
#   #
#   #
#   #
#   #
#   #
#   #
#   #
#   #
#   #
#   #
#   #
#   #
#   #
#   #
#   #
#   #
#   #
#   #
#   #
#   #
#   #
#   #
#   #
#   #
#   #
#   #
#   #
#   #
#   #
#   #
#   #
#   #
#   #
#   #
#   #
#   #
#   #
#   #
#   #
#   #
#   #
#   #
#   #
#   #
#   #
#   #
#   #
#####