############
#    #   ###
##### # ####
#  #  #E# ##
############