##########
#S   #   #
##### # ##
#     # ##
##########