##########
#    #   #
##### # ##
#     #E##
##########