##########
#S   #   #
##### # ##
# E   #E##
##########