##########
#S  #   S#
##### # ##
#     #E##
##########